$
ROO-4097
S L L L L L S L
L S L R S L L L
L R L S S S S L
S L L L L R L L
S T S L L L S L
L S L L T L R L
L S L L S L S S
L L L R R R S L
L L T R L S T L
$
