$
ROO-5341
T L S S L L L
L L S L L T L
R L R S L R S
S S S T S R L
T T T S L L L
$
