$
ROO-5341
T L S S L L L
L L S L L T L
R L R S L R S
S S S T S R L
T T T S L L L
$
$
ROO-5307
L S L L L L S L L S
S S S L L L L S L S
S T R L L L S S T L
L L L L L S S L L T
L L L L R S L S S L
L L R S L T R T S S
$
$
ROO-5248
S L L L S S S S L L
S L L S L T S T S R
S S L S T R L S L L
T S L S L S S L L S
L L R S L R S S S S
L S T L S T L L S L
S L L L S L L L S S
S L L S S S S S R R
L T R L R L L S S S
$
$
ROO-7120
T L L L
T L L L
L S T S
L L L S
$
